7 7 7 7 7 7 7 7 7 7 7 7 7 7 7 7
7 6 6 6 6 6 6 6 6 6 6 6 6 6 6 7
7 6 6 6 6 6 6 6 6 6 6 6 6 6 6 7
7 1 6 6 6 6 6 6 6 6 6 6 6 6 6 7
7 6 6 6 6 6 6 6 6 6 6 6 6 6 6 7
7 6 6 6 6 6 6 6 6 6 6 6 6 6 6 7
1 1 1 1 6 6 6 6 6 6 6 6 6 6 1 1
9 6 6 6 6 6 6 1 1 6 6 6 6 6 6 7
9 6 6 6 6 6 6 1 6 6 6 6 6 6 6 7
9 6 6 6 1 1 6 1 6 6 6 1 1 1 1 1
1 1 1 1 1 1 6 1 6 6 6 6 6 6 6 7
1 1 1 1 1 1 10 1 3 3 3 3 3 3 3 3 