7 7 7 7 7 1 11 1 7 7 1 1 7 7 7 7
7 6 6 6 6 1 6 1 6 6 1 1 6 6 6 7
7 6 6 6 6 6 6 6 6 6 1 1 6 6 6 7
7 6 6 6 6 6 6 6 6 6 1 1 6 6 6 7
7 6 6 6 6 6 6 6 6 6 1 1 6 6 6 7
7 6 6 6 6 6 6 6 6 6 6 6 6 6 6 7
7 6 6 6 6 6 6 6 6 6 6 6 6 6 6 14
12 6 6 6 6 1 1 1 6 6 6 6 6 6 6 14
12 6 6 6 6 6 6 6 6 6 6 6 6 6 6 14
12 6 6 6 6 6 6 6 6 6 6 1 1 1 1 1
1 6 1 1 6 6 6 6 6 6 6 1 1 1 1 1
1 3 1 1 3 3 3 3 3 3 3 1 1 1 1 1 