7 7 7 7 7 7 7 7 7 7 7 7 7 7 7 7
7 6 6 6 6 6 6 6 6 6 6 6 6 6 6 7
7 6 6 6 6 6 6 6 6 6 6 6 6 6 6 7
7 6 6 6 6 6 6 6 6 6 6 6 6 6 6 7
17 6 6 6 6 6 6 6 6 6 6 6 6 6 6 7
17 6 6 6 6 6 6 6 6 6 6 6 6 6 6 7
17 6 6 6 6 6 6 6 6 6 6 6 6 6 6 7
1 1 1 1 1 6 6 6 6 6 6 6 6 6 6 13
1 1 1 1 1 6 6 6 6 6 6 6 6 6 6 13
1 1 1 1 1 6 6 6 6 6 6 6 1 1 1 13
1 1 1 1 1 6 6 6 6 6 6 6 6 6 6 1
1 1 1 1 1 3 3 3 3 3 3 3 3 3 3 3 