7 7 7 7 7 7 7 7 7 18 18 18 1 1 1 1
7 6 6 6 6 6 6 6 6 6 6 6 6 6 6 7
7 6 6 6 6 6 6 6 6 6 6 6 6 6 6 7
7 6 6 6 6 6 6 6 6 1 1 6 6 6 6 7
7 6 6 6 6 6 6 6 6 6 6 6 6 6 6 16
7 6 6 6 6 6 1 1 6 6 6 6 6 6 6 16
15 6 6 6 6 6 6 1 6 6 6 6 6 6 6 16
15 6 6 6 1 1 6 1 1 1 1 6 6 1 1 1
15 6 6 6 6 6 6 6 6 6 6 6 6 1 1 1
1 1 1 1 6 6 6 6 6 6 6 6 6 1 1 1
1 1 1 1 6 6 6 6 6 6 6 6 6 1 1 1
1 1 1 1 3 3 3 3 3 3 3 3 3 1 1 1 