7 7 7 7 7 7 7 7 7 7 7 7 7 7 7 7 
7 6 6 6 6 6 6 6 6 6 6 6 6 6 6 7
7 6 6 6 6 6 6 6 6 6 6 6 6 6 6 7
7 6 6 6 6 6 6 6 6 6 6 6 6 6 6 7
7 6 6 6 6 6 6 6 6 6 6 6 6 6 6 7
7 6 6 6 6 6 6 6 6 6 6 6 6 6 6 7
7 6 6 6 6 6 6 6 6 6 6 6 6 6 6 7
7 6 6 6 6 6 6 6 6 6 6 6 6 6 6 7
7 6 6 6 6 6 6 6 6 6 6 6 6 6 6 7
1 1 1 1 1 1 1 1 1 1 6 6 6 6 6 7
7 6 6 6 6 6 6 6 6 6 6 6 6 6 6 7
7 7 7 7 7 7 7 7 7 19 19 19 1 1 1 1 